WIDTH:20
HEIGHT:10
---
####################
#...................#
#...................#
#...................#
#...................#
#...................#
#...................#
#...................#
#...................#
#####################