####################
#........#...#######
#.######.#.#.#######
#.######.#.#.#######
#...####.#.#.#######
###.####.#.#.#######
###.####...#.#######
#...########.#######
#.######...#.......#
#.#....#.#.#######.#
#.#.##...#.........#
#.#...##############
#.###.##...........#
#.#...##.#########.#
#.#.####.........#.#
#.#...##########.#.#
#.###............#.#
#.################.#
#..................#
####################