#########.##########
#..................#
#..................#
#..................#
....................
#..................#
#..................#
#..................#
#..................#
#########.##########